WWWWWWWWWWWWWWWWWWWWWWWWWWWWWWWWWWWWWWWWWWWWWWWWWWWWW
WFFFFWWFFFFFFFFFFWWWWWWWWWWWWWWFFFFFFFWWWFFFFFFFWWWWW
WFFFFWWFWFWWWWWWFWWWWWFFFFFFFFFFWWWWWFFFFFWWWWWFWWWWW
WFFFFWWFWFWWWWWWFWWWWFWWWWWWWWFWWWWWWWWWWWWWWWFWWWWW
WFFWWWWWWFWWWWWWFFFFFFFFFFWFFFFFFFFFFFFFFFFFFFFFFFFWW
WFFFFFFFFFWWWWWWFWWWWWWFWWWFWWWWWWWWWFWWWWWWWWWWWWFWW
WWWWWWWWWFFFFFFFFFWFFFWFWWWFWWWFFFFFFFFFFFWWWWWWWWFWW
WWWWFFFFWFWWWWWWWWWFWWWFWWWFWWWFWWWWWWWWWFWWWWWWWWFWW
WWWWFFFFWWWWWWWWFFFFWWWFWWWFWWWFWWWWWWWWWFWWWWWWWWFWW
WFFFFWWWWWWWWWWWFWWWWWWFWWWFFFFFWWWWWFFFFFFFFFWWWWFWW
WFWWWWWWWWWWWFFFFFFFFFFFWWWWWWWFWWWWWWFWWWWWWFWWWWFWW
WFFWWWWWWWWWWFWWWWWWWWWWWWWWWWWFWWWWWWFFFWWWWFWWWWFWW
WWFWWWWWWWWWWFWWFFFFWWWWWWWWWWWWWWWWWWWWWWWWWFWWWWFWW
WWFWWWWWWWWWWFWWWWWFFFFFFFFFFFFFFFFFFFFFFFFFFFFFWWFWW
WFFFFFFFFFFFFFWFFFFFWWWWWWWFWWWFWWWWWWWWWWWWWWWWWWFWW
WWWWWFWWWWWWWWWFWWWWWWWWWWWFWWWFFFWWWWWWWWWWWWWWWWFWW
WWWWWFFFFFFFFFFFWWWWWWWWWWFFFFWFFFFFFFFFFFFFFFFFFFFWW
WWWWWWWWWWWWWWWWWWWWWWWWWWWWWWWWWWWWWWWWWWWWWWWWWWWWW