WWWWWWWWWW
WFFFFFFFFW
WFWWWWFWFW
WFFFWWFFFW
WFFFWWWFWW
WFFFFFFFWW
WWWWWWWWWW