WWWWWWW
WFFFFFW
WFFFFFW
WFFWFFW
WFFFFFW
WFFFFFW
WWWWWWW