WWWWWWWWWW
WFFFWWFFFW
WFWFWWWFWW
WFFFFFFFWW
WWWWWWWWWW