WWWWWWWWWWWWWWWWWWWWWWWWW
WFFFFWWFFFFFFFFFFWWWWWWWW
WFFFFWWFWFWWWWWWFWWWWFFWW
WFFFFWWFWFWWWWWWFWWWWFWWW
WFFWWWWWWFWWWWWWFFFFFFFFW
WFFFFFFFFFWWWWWWFWWWWWWFW
WWWWWWWWWFFFFFFFFFWFFFWFW
WWWWFFFFWFWWWWWWWWWFWWWFW
WWWWFFFFWWWWWWWWFFFFWWWFW
WWWWWWWWWWWWWWWWWWWWWWWWW